hatsune miku,vocaloid,1girl,aqua eyes,blue eyes,very long hair,aqua hair,long hair,twintails,detached sleeves	初音未来 – Vocaloid（虚拟歌手）
hakurei reimu,touhou,1girl,brown eyes,red eyes,brown hair,long hair,black hair,hair bow,hair tubes,red bow,detached sleeves	博丽灵梦 – 东方Project（主角，神社巫女）
kirisame marisa,touhou,1girl,yellow eyes,blonde hair,long hair,single braid,witch hat	雾雨魔理沙 – 东方Project（主角，魔法师）
izayoi sakuya,touhou,1girl,maid,maid headdress,maid,blue eyes,grey hair,short hair,twin braids	十六夜咲夜 – 东方Project（红魔馆的女仆）
admiral \(kancolle\),kantai collection,1girl,long hair,naval uniform	舰长（舰队Collection） – 舰队Collection（舰船少女，代表不同舰船）
artoria pendragon \(fate\),fate \(series\),1girl,green eyes,hair between eyes,blonde hair,long hair,ahoge,sidelocks	阿尔托莉亚·潘德拉贡（Fate） – Fate系列（Saber，亚瑟王的英灵）
kochiya sanae,touhou,1girl,green eyes,green hair,long hair,frog hair ornament,snake hair ornament,hair tubes,large breasts,detached sleeves,snake	东风谷早苗 – 东方Project（守矢神社的巫女）
konpaku youmu,touhou,1girl,blue eyes,short hair,white hair,grey hair,black hairband,hair ribbon,katana	魂魄妖梦 – 东方Project（半人半妖，剑士）
alice margatroid,touhou,1girl,blue eyes,blonde hair,short hair,hairband	爱丽丝·玛格特罗依德 – 东方Project（魔法师，傀儡使）
komeiji koishi,touhou,1girl,green eyes,third eye,green hair,short hair,yellow shirt,hat ribbon,green skirt,long sleeves,wide sleeves,eyeball,heart of string	古明地こいし – 东方Project（精神力使，古明地紫的妹妹）
patchouli knowledge,touhou,1girl,purple eyes,purple hair,long hair,crescent hat ornament,hat	帕秋莉·诺雷姬 – 东方Project（魔法师，红魔馆的图书馆管理员）
yakumo yukari,touhou,1girl,purple eyes,blonde hair,long hair,large breasts,hat ribbon,mob cap	八云紫 – 东方Project（边界妖怪）
fujiwara no mokou,touhou,1girl,red eyes,white hair,very long hair,long hair,grey hair,hair bow,suspenders	藤原妹红 – 东方Project（不死妖怪）
akemi homura,mahou shoujo madoka magica,1girl,purple eyes,long hair,black hair,hairband,magical girl,magical girl	晓美焰 – 魔法少女小圆（猎巫者，时间旅行者）
komeiji satori,touhou,1girl,pink eyes,purple eyes,third eye,short hair,pink hair,purple hair,hairband,long sleeves,eyeball,heart	古明地沙织 – 东方Project（妖怪，能读取他人心思）
kaname madoka,mahou shoujo madoka magica,1girl,pink eyes,pink hair,short hair,short twintails,hair ribbon,hair bow,white gloves,magical girl,magical girl	鹿目圆 – 魔法少女小圆（主角，魔法少女）
hong meiling,touhou,1girl,blue eyes,red hair,long hair,twin braids,large breasts,hat	红美铃 – 东方Project（红魔馆的门卫）
saigyouji yuyuko,touhou,1girl,pink eyes,pink hair,short hair,large breasts,blue kimono,hat,mob cap,triangular headpiece	西行寺幽幽子 – 东方Project（幽灵，冥界之主）
inubashiri momiji,touhou,1girl,wolf ears,wolf tail,red eyes,short hair,white hair,tokin hat,pom pom (clothes),detached sleeves	犬走椛 – 东方Project（白狼天狗）
kaga \(kancolle\),kantai collection,1girl,brown eyes,brown hair,short hair,long hair,side ponytail,large breasts	加贺（舰队收藏）
kagamine rin,vocaloid,1girl,blue eyes,blonde hair,short hair,hair bow,hairclip	镜音铃
konpaku youmu \(ghost\),touhou,1girl,blue eyes,short hair,white hair,grey hair,black hairband,hair ribbon,katana,ghost	魂魄妖梦（幽灵）
rumia,touhou,1girl,red eyes,blonde hair,short hair,hair ribbon	露米亚
moriya suwako,touhou,1girl,yellow eyes,blonde hair,short hair,hair ribbon,hat,wide sleeves,long sleeves	守矢苏瓦克
shimakaze \(kancolle\),kantai collection,1girl,long hair,blonde hair,hairband,navel,serafuku,elbow gloves,striped clothes,striped thighhighs,white gloves,black panties,highleg panties,pleated skirt,crop top	岛风（舰队收藏）
miki sayaka,mahou shoujo madoka magica,1girl,blue eyes,blue hair,short hair,cape,magical girl,magical girl	美树沙耶香
kazami yuuka,touhou,1girl,red eyes,green hair,short hair,large breasts,plaid vest,plaid skirt,ascot	风见幽香
saber \(fate\),fate \(series\),1girl,green eyes,blonde hair,ahoge,hair ribbon	剑士（最终幻想14）
sensei \(blue archive\),blue archive,1girl,long hair,very long hair,black hair,large breasts,halo,long sleeves	老师
mash kyrielight,fate \(series\),1girl,purple eyes,hair over one eye,short hair,pink hair,purple hair,large breasts,navel,bare shoulders	玛修·基列莱特
hibiki \(kancolle\),kantai collection,1girl,blue eyes,hair between eyes,long hair,grey hair,white hair,serafuku,serafuku,flat cap,pleated skirt,long sleeves	响（舰队收藏）
kawashiro nitori,touhou,1girl,blue eyes,blue hair,short hair,two side up,hair bobbles,hat,backpack,key	河城荷取
shigure \(kancolle\),kantai collection,1girl,blue eyes,hair between eyes,long hair,brown hair,black hair,single braid,ahoge,hair flaps,hair over shoulder,hair ornament	时雨（舰队收藏）
kamishirasawa keine,touhou,1girl,red eyes,long hair,blue hair,large breasts,hat	上白泽慧音
hinanawi tenshi,touhou,1girl,red eyes,blue hair,long hair,very long hair,hat	雏奈尔天子
sakura kyoko,mahou shoujo madoka magica,1girl,red eyes,red hair,long hair,ponytail,hair bow,magical girl	樱桃京子
tomoe mami,mahou shoujo madoka magica,1girl,yellow eyes,blonde hair,long hair,drill hair,twintails,large breasts,fingerless gloves,twin drills,magical girl,magical girl,beret	巴麻美
houraisan kaguya,touhou,1girl,red eyes,black hair,long hair,very long hair,long sleeves,hime cut	蓬莱山辉夜
raiden shogun,genshin impact,1girl,purple eyes,mole under eye,purple hair,long hair,very long hair,braided ponytail,hair ornament,large breasts,cleavage,thighs,purple kimono,purple nails,obi,bridal gauntlets	雷电将军
lumine \(genshin impact\),genshin impact,1girl,yellow eyes,hair between eyes,blonde hair,short hair with long locks,sidelocks,hair flower,medium breasts,large breasts,cleavage,white dress,bare shoulders	露米娜（原神）
souryuu asuka langley,neon genesis evangelion,1girl,blue eyes,hair between eyes,long hair,orange hair,brown hair,two side up,medium breasts,plugsuit,plugsuit,pilot suit,red bodysuit,interface headset	明日香（新世纪福音战士）
kongou \(kancolle\),kantai collection,1girl,purple eyes,long hair,brown hair,ahoge,double bun,hairband,large breasts,japanese clothes,japanese clothes,detached sleeves,bare shoulders,nontraditional miko,headgear,nontraditional miko	长门（舰队收藏）
nazrin,touhou,1girl,mouse ears,mouse tail,red eyes,grey hair,short hair,mouse (animal),pendant	那珂
gawr gura,hololive,1girl,shark girl,shark tail,sharp teeth,blue eyes,streaked hair,blue hair,grey hair,long hair,medium hair,shark hair ornament,blunt bangs,two side up,blue hoodie,long sleeves,virtual youtuber,virtual youtuber,blue nails,fins	Gawr Gura
inazuma \(kancolle\),kantai collection,1girl,brown eyes,hair between eyes,brown hair,long hair,folded ponytail,serafuku,serafuku	稻妻（舰队收藏）
hijiri byakuren,touhou,1girl,yellow eyes,gradient hair,long hair,purple hair,blonde hair,brown hair,large breasts	聖白莲
akagi \(kancolle\),kantai collection,1girl,brown eyes,long hair,brown hair,japanese clothes,muneate	赤城（舰队收藏）
fujimaru ritsuka \(female\),fate \(series\),1girl,hair between eyes,orange eyes,yellow eyes,orange hair,short hair,ahoge,side ponytail,hair scrunchie,medium breasts,one side up	藤丸立香（女性）
inkling player character,splatoon \(series\),1girl,pointy ears,tentacle hair,long hair,blunt bangs	墨水玩家角色
jeanne d'arc alter \(fate\),fate \(series\),1girl,yellow eyes,hair between eyes,white hair,short hair,grey hair,very long hair,ahoge,large breasts,cleavage	贞德Alter（Fate）
megurine luka,vocaloid,1girl,blue eyes,pink hair,long hair,very long hair	巡音流歌
yasaka kanako,touhou,1girl,red eyes,short hair,purple hair,leaf hair ornament,large breasts,shimenawa,mirror	八坂神奈子
yagokoro eirin,touhou,1girl,blue eyes,grey hair,long hair,very long hair,white hair,braid,single braid,large breasts,nurse cap	八极院绯麟
yuudachi \(kancolle\),kantai collection,1girl,red eyes,long hair,blonde hair,hair flaps,hair ribbon,hairclip,black ribbon	夕立（舰队收藏）
gotoh hitori,bocchi the rock!,1girl,blue eyes,hair between eyes,pink hair,long hair,cube hair ornament,large breasts,pink jacket,track jacket,long sleeves,one side up	五岛独
hu tao \(genshin impact\),genshin impact,1girl,red eyes,hair between eyes,flower-shaped pupils,brown hair,very long hair,long hair,twintails,thighs,hat flower,black headwear,long sleeves,black nails,nail polish,ghost	胡桃（原神）
mizuhashi parsee,touhou,1girl,pointy ears,green eyes,blonde hair,short hair,arm warmers	水桥帕尔塞
princess zelda,the legend of zelda,1girl,pointy ears,blue eyes,green eyes,blonde hair,long hair,short hair,crown braid,parted bangs	塞尔达公主
tifa lockhart,final fantasy,1girl,red eyes,brown eyes,black hair,long hair,low-tied long hair,brown hair,large breasts,navel,fingerless gloves,elbow gloves,black skirt,suspender skirt,bare shoulders,earrings,crop top,midriff	蒂法·洛克哈特
fubuki \(kancolle\),kantai collection,1girl,green eyes,black hair,short hair,brown hair,ponytail,short ponytail,sidelocks,low ponytail,serafuku,serafuku,pleated skirt	吹雪（舰队收藏）
abigail williams \(fate\),fate \(series\),1girl,blue eyes,blonde hair,very long hair,long hair,parted bangs,hair bow,small breasts,orange bow,black bow,polka dot bow,long sleeves,forehead	阿比盖尔·威廉姆斯（Fate）
ikazuchi \(kancolle\),kantai collection,1girl,fang,brown eyes,brown hair,short hair,hairclip,serafuku,serafuku	雷电（舰队收藏）
akatsuki \(kancolle\),kantai collection,1girl,purple eyes,hair between eyes,long hair,purple hair,black hair,serafuku,serafuku,flat cap,anchor symbol,red neckerchief	晓（舰队收藏）
zuikaku \(kancolle\),kantai collection,1girl,green eyes,long hair,green hair,twintails,hair ribbon	瑞鹤（舰队收藏）
akiyama mio,k-on!,1girl,black eyes,long hair,black hair,sakuragaoka high school uniform,hime cut	秋山澪
kagiyama hina,touhou,1girl,green eyes,green hair,long hair,front ponytail,hair ribbon,hair bow	辉夜姬
inkling girl,splatoon \(series\),1girl,pointy ears,tentacle hair,long hair,orange hair,blunt bangs	墨水女孩
toyosatomimi no miko,touhou,1girl,brown eyes,yellow eyes,short hair,pointy hair,brown hair,blonde hair,bracelet,earmuffs	丰饶之实的未来
suzumiya haruhi,suzumiya haruhi no yuuutsu,1girl,brown eyes,brown hair,short hair,medium hair,hair ribbon,kita high school uniform,serafuku,winter uniform,kita high school uniform,serafuku,winter uniform,blue sailor collar	凉宫春日
hamakaze \(kancolle\),kantai collection,1girl,blue eyes,hair over one eye,short hair,grey hair,hairclip,large breasts,serafuku,serafuku,short sleeves	滨风（舰队收藏）
nero claudius \(fate\),fate \(series\),1girl,green eyes,hair between eyes,blonde hair,long hair,single hair bun,ahoge,hair intakes,large breasts,cleavage	尼禄·克劳狄乌斯（Fate）
doodle sensei \(blue archive\),blue archive,1girl,blue eyes,long hair,very long hair,black hair,large breasts,halo,long sleeves	涂鸦老师（蓝档案）
haruna \(kancolle\),kantai collection,1girl,brown eyes,hair between eyes,long hair,black hair,hairclip,hairband,large breasts,japanese clothes,detached sleeves,bare shoulders,nontraditional miko,headgear,nontraditional miko	春雨（舰队收藏）
2b \(nier:automata\),nier \(series\),1girl,mole under mouth,short hair,white hair,black hairband,medium breasts,large breasts,cleavage cutout,cleavage,ass,thighs,thigh boots,highleg leotard,black thighhighs,black dress,black gloves,juliet sleeves,black blindfold	2B（尼尔：自动人形）
gardevoir,pokemon,1girl,white skin,two-tone skin,green skin,red eyes,hair over one eye,one eye covered,short hair,green hair,bob cut,flat chest,pokemon (creature)	沙奈朵
hoshimachi suisei,hololive,1girl,blue eyes,hair between eyes,star in eye,blue hair,long hair,medium hair,official alternate hairstyle,side ponytail,hair ribbon,small breasts,virtual youtuber,virtual youtuber	星街彗星
nagato \(kancolle\),kantai collection,1girl,red eyes,hair between eyes,long hair,black hair,large breasts,navel,elbow gloves,headgear	长门（舰队收藏）
nanami chiaki,danganronpa \(series\),1girl,pink eyes,medium hair,flipped hair,brown hair,pink hair,hair ornament,large breasts,white shirt,collared shirt,open jacket,black jacket,dress shirt,pleated skirt,hooded jacket,black shirt,neck ribbon,long sleeves,pink ribbon,backpack	七海千秋
shiroko \(blue archive\),blue archive,1girl,wolf ears,animal ear fluff,extra ears,blue eyes,hair between eyes,mismatched pupils,grey hair,medium hair,cross hair ornament,medium breasts,large breasts,thighs,competition swimsuit,halo	白子（蓝档案）
kashima \(kancolle\),kantai collection,1girl,blue eyes,grey hair,wavy hair,long hair,twintails,sidelocks,large breasts,military uniform,beret,epaulettes	鹿岛（舰队收藏）
fate testarossa,lyrical nanoha,1girl,red eyes,blonde hair,long hair,very long hair,twintails	Fate特斯塔罗莎
shigure kai ni \(kancolle\),kantai collection,1girl,blue eyes,hair between eyes,long hair,brown hair,black hair,hair flaps,single braid,ahoge,hair over shoulder,hair ornament	时雨改二（舰队收藏）
nishizumi miho,girls und panzer,1girl,brown eyes,short hair,brown hair,ooarai school uniform,serafuku,long sleeves	西住美穗
mononobe no futo,touhou,1girl,blue eyes,grey eyes,grey hair,long hair,ponytail,wide sleeves,long sleeves,kariginu,tate eboshi,kariginu	物部布都
tohsaka rin,fate \(series\),1girl,blue eyes,long hair,black hair,brown hair,two side up,hair ribbon,medium breasts,black thighhighs	远坂凛
usami renko,touhou,1girl,brown eyes,brown hair,short hair,hat bow,white shirt,white bow	宇佐见莲子
wriggle nightbug,touhou,1girl,green eyes,green hair,short hair,cape,antennae	萤火虫
shanghai doll,touhou,1girl,blue eyes,blonde hair,short hair,long hair,hair bow,hairband,capelet,doll	上海人偶
shiki eiki,touhou,1girl,blue eyes,green eyes,green hair,short hair,hat,rod of remorse	四季映姬
misaka mikoto,toaru majutsu no index,1girl,brown eyes,brown hair,short hair,medium hair,small breasts,tokiwadai school uniform,tokiwadai school uniform	御坂美琴
rem \(re:zero\),re:zero kara hajimeru isekai seikatsu,1girl,maid,maid,maid headdress,blue eyes,hair over one eye,blue hair,short hair,x hair ornament,hair ribbon,medium breasts,large breasts,cleavage,roswaal mansion maid uniform,roswaal mansion maid uniform,detached sleeves	蕾姆（Re:从零开始的异世界生活）
nagato yuki,suzumiya haruhi no yuuutsu,1girl,brown eyes,short hair,purple hair,kita high school uniform,serafuku,winter uniform,kita high school uniform,serafuku,winter uniform,blue skirt,blue sailor collar	长门有希
nakano azusa,k-on!,1girl,brown eyes,long hair,black hair,twintails,sakuragaoka high school uniform,sakuragaoka high school uniform	中野梓
onozuka komachi,touhou,1girl,red eyes,red hair,short hair,two side up,hair bobbles,large breasts,cleavage,scythe	小野塚小町
maribel hearn,touhou,1girl,purple eyes,blonde hair,short hair,long hair,mob cap,purple dress	玛丽贝尔·赫恩
producer \(idolmaster\),idolmaster,1girl,short hair,black hair,brown hair	制作人（偶像大师）
illyasviel von einzbern,fate \(series\),1girl,red eyes,hair between eyes,long hair,white hair,blonde hair,small breasts	伊莉雅斯菲尔·冯·爱因兹贝伦
manjuu \(azur lane\),azur lane,1girl,hair between eyes,red eyes,very long hair,long hair,white hair,large breasts,cleavage,thighs,bare shoulders,chick	饼干（碧蓝航线）
suzuya \(kancolle\),kantai collection,1girl,aqua eyes,green eyes,hair between eyes,long hair,aqua hair,green hair,hairclip,large breasts,school uniform	铃谷（舰队收藏）
ayanami rei,neon genesis evangelion,1girl,red eyes,hair between eyes,blue hair,short hair,medium breasts,plugsuit,plugsuit,white bodysuit	绫波丽
