style by calculus_0001,	calculus_0001
style by nikukyu,	nikukyu
style by E_0x0194_type1_iloveclipleaking,	E_0x0194_type1
style by pnya,	pnya
style by flooxyfloox,	flooxyfloox
style by lativi,	lativi
style by lucifel99_type1,	lucifel99_type1
style by shutenanon,	shutenanon
style by xi410_type2,	xi410_type2
style by xi410_type3,	xi410_type3
style by afezeria,	afezeria
style by amindarano,	amindarano
style by firedotinc,	firedotinc
style by galawave,	galawave
style by half-ai_creator,	half-ai_creator
style by hllv,	hllv
style by joongyong,	joongyong
style by localranko,	localranko
style by nyalia_2025,	nyalia_2025
style by sabotenman,	sabotenman
style by wheelinghubcap,	wheelinghubcap
style by xi410_type1,	xi410_type1
style by youlichu,	youlichu
style by aipotions,	aipotions
style by alens,	alens
style by aruhshura,	aruhshura
style by bakariso,	bakariso
style by bkrs_t2,	bkrs_t2
style by bb_ta,	bb_ta
style by dj_eban,	dj_eban
style by kyomu,	kyomu
style by nyalia,	nyalia
style by nyaqiq,	nyaqiq
style by ramwam,	ramwam
style by shiroski,	shiroski
style by sbmssvmt_v2,	sbmssvmt_v2
style by sllq_t2,	sllq_t2
style by tencarcyan_old_type1,	tencarcyan_old_type1
style by youmuanon_v2,	youmuanon_v2
style by yukihotaru_type1,	yukihotaru_type1
style by yukihotaru_type2,	yukihotaru_type2
style by anonnoodles,	anonnoodles
style by chlenix,	chlenix
style by cleandongye,	cleandongye
style by deadpurity,	deadpurity
style by E_0x0194_type3_whatevertowrite,	E_0x0194_type3
style by fltccktl,	fltccktl
style by funnygrifter,	funnygrifter
style by honkail,	honkail
style by localnoodles,	localnoodles
style by merratatustle,	merratatustle
style by notamamizore,	notamamizore
style by rikku-143,	rikku-143
style by sakurakono,	sakurakono
style by shoebillanon,	shoebillanon
style by syllque,	syllque
style by trauter,	trauter
style by unknown_anon_2,	unknown_anon_2
style by unnamed_style_3,	unnamed_style_3
style by yafkyu,	yafkyu
style by E_0x0194_type2_uniquestring,	E_0x0194_type2
style by E_0x0194_type4_dontask,	E_0x0194_type4
style by lattekoi5252,	lattekoi5252
style by yewangxiaotao,	yewangxiaotao
style by brittle,	brittle
style by lucifel99_type2,	lucifel99_type2
style by tencarcyan_old_type2,	tencarcyan_old_type2
style by memento mori,	memento mori